#######################################
#.....................................#
#.....................................#
#.....................................#
#..............#......................#
#..............#......................#
#..............#......................#
#..............#......................#
#..............################.......#
#.............................#.......#
#.............................#.......#
#.............................#.......#
#.............#...............#.......#
#.............#...............#.......#
#.............#...............#.......#
#.............###########...###.......#
#.....................................#
#.....................................#
#.....................................#
#.....................................#
#.....................................#
#.....................................#
#.....................................#
#.....................................#
#.....................................#
#.....................................#
#.....................................#
#.....................................#
#######################################
#*************************************#
#*************************************#
#*************************************#
#*************************************#
#*************************************#
#*************************************#
#*************************************#
#*************************************#
#*************************************#
#*************************************#
#######################################







