#######################################
#.....................................#
#.....................................#
#.....................................#
#..............#......................#
#..............#......................#
#..............#......................#
#..............#......................#
#..............################.......#
#.............................#.......#
#.............................#.......#
#.............................#.......#
#.............#...............#.......#
#.............#...............#.......#
#.............#...............#.......#
#.............###########...####......#
#.....................#........#......#
#.....................#........#......#
#.....................#........#......#
#.....................#........#......#
#.....................#####..###......#
#..............................#......#
#..............................#......#
#...........................####......#
#.....................................#
#.....................................#
#.....................................#
#.....................................#
#######################################
#*************************************#
#*************************************#
#*************************************#
#*************************************#
#*************************************#
#*************************************#
#*************************************#
#*************************************#
#*************************************#
#*************************************#
#######################################







