#######################################
#.....................................#
#.....................................#
#.....................................#
#.....................................#
#............................... #....#
#...............................#.....#
#.....................................#
#.....................................#
#................................#....#
#.......################...#######....#
#...........#.........................#
#...........#.........................#
#...........#.........................#
#.............###################.....#
#............#........................#
#.....................................#
#.....................................#
#.....................................#
#.....................................#
#.....................................#
#.....................................#
#.....................................#
#.....................................#
#.....................................#
#.....................................#
#.....................................#
#.....................................#
#.....................................#
#######################################
*.....................................*
*.....................................*
*.....................................*
*.....................................*
*.....................................*
*.....................................*
*.....................................*
***************************************